{
    "maxLevel": 50,
    "resources": {
        "human": [
            5, 8, 11, 14, 17, 20, 23, 26, 29, 32,
            35, 38, 41, 44, 47, 50, 53, 56, 59, 62,
            65, 68, 71, 74, 77, 80, 83, 86, 89, 92,
            95, 98, 101, 104, 107, 110, 113, 116, 119, 122,
            125, 128, 131, 134, 137, 140, 143, 146, 149, 152
        ],
        "wood": [
            1000, 1500, 2000, 2500, 3000, 3500, 4000, 4500, 5000 ,5500,
            6000, 6500, 7000, 7500, 8000, 8500, 9000, 9500, 10000 ,10500,
            11000, 11500, 12000, 12500, 13000, 13500, 14000, 14500, 15000, 15500,
            16000, 16500, 17000, 17500, 18000, 18500, 19000, 19500, 20000, 20500,
            21000, 21500, 22000, 22500, 23000, 23500, 24000, 24500, 25000, 25500
        ],
        "stone": [
            2000, 3000, 4000, 5000, 6000, 7000, 8000, 9000, 10000 ,11000,
            12000, 13000, 14000, 15000, 16000, 17000, 18000, 19000, 20000, 21000,
            22000, 23000, 24000, 25000, 26000, 27000, 28000, 29000, 30000, 31000,
            32000, 33000, 34000, 35000, 36000, 37000, 38000, 39000, 40000, 41000,
            42000, 43000, 44000, 45000, 46000, 47000, 48000, 49000, 50000, 51000
        ],
        "food": [
            40, 60, 80, 100, 120, 140, 160, 180, 200, 220,
            240, 260, 280, 300, 320, 340, 360, 380, 400, 420,
            440, 460, 480, 500, 520, 540, 560, 580, 600, 620,
            640, 660, 680, 700, 720, 740, 760, 780, 800, 820,
            840, 860, 880, 900, 920, 940, 960, 980, 1000, 1020
        ],
        "ironOre": [
            200, 350, 500, 650, 800, 950, 1100, 1250, 1400 ,1550,
            1700, 1850, 2000, 2150, 2300, 2450, 2600, 2750, 2900, 3050,
            3200, 3350, 3500, 3650, 3800, 3950, 4100, 4250, 4400, 4550,
            4700, 4850, 5000, 5150, 5300, 5450, 5600, 5750, 5900, 6050,
            6200, 6350, 6500, 6650, 6800, 6950, 7100, 7250, 7400, 7550
        ],
        "iron": [
            0, 0, 0, 0, 0, 0, 0, 0, 0, 0,
            0, 0, 0, 0, 0, 0, 0, 0, 0, 0,
            0, 0, 0, 0, 0, 0, 0, 0, 0, 0,
            0, 0, 0, 0, 0, 0, 0, 0, 0, 0,
            0, 1000, 3000, 4000, 5000, 6000, 7000, 8000, 10000, 12000
        ]
    },
    "buildings": [
        [
            4, 4, 6, 6, 8, 8, 10, 10, 12, 12,
            14, 14, 16, 16, 18, 18, 20, 20, 22, 22,
            24, 24, 26, 26, 28, 28, 30, 30, 32, 32,
            34, 34, 36, 36, 38, 38, 40, 40, 42, 42,
            44, 44, 46, 46, 48, 48, 50, 50, 52, 52
        ],
        [
            0, 0, 0, 2, 2, 2, 4, 4, 4, 6,
            6, 6, 8, 8, 8, 10, 10, 10, 12, 12,
            12, 14, 14, 14, 16, 16, 16, 18, 18, 18,
            20, 20, 20, 22, 22, 22, 24, 24, 24, 26,
            26, 26, 28, 28, 28, 30, 30, 30, 32, 32
        ],
        [
            0, 0, 0, 0, 0, 2, 2, 2, 2, 2,
            4, 4, 4, 4, 4, 6, 6, 6, 6, 6,
            8, 8, 8, 8, 8, 10, 10, 10, 10, 10,
            12, 12, 12, 12, 12, 14, 14, 14, 14, 14,
            16, 16, 16, 16, 16, 18, 18, 18, 18, 18
        ]
    ],
    "unlock_agents": [
        ["church"], [], [], ["quarry"], [], [], ["sawmill"], [], [], ["farm"],
        [], [], ["forge"], [], [], [], [], [], [], [],
        [], [], [], [], [], [], [], [], [], [],
        [], [], [], [], [], [], [], [], [], [],
        [], [], [], [], [], [], [], [], [], []
    ],
    "building_requirements": [
        2, 4, 6, 8, 10, 12, 14, 16, 18, 20,
        22, 24, 26, 28, 30, 32, 34, 36, 38, 40,
        42, 44, 46, 48, 50, 52, 54, 56, 58, 60,
        62, 64, 66, 68, 70, 72, 74, 76, 78, 80,
        82, 84, 86, 88, 90, 92, 94, 96, 98, 100
    ]
}
